20 13
100 100
4 4 4 4 4 4 4 4 4 4 4 4 4 4 4 4 4 4 4 4
4 2 2 2 2 2 2 2 2 2 2 2 2 2 2 2 2 2 2 4
4 2 2 2 2 4 4 4 4 4 2 2 2 2 2 2 2 2 2 4
4 3 3 3 3 4 4 4 4 4 3 3 3 3 3 2 2 2 2 4
4 2 2 2 2 4 4 4 4 4 2 2 2 2 2 2 2 2 2 4
4 3 3 3 3 4 4 4 4 4 3 3 3 3 3 2 2 2 2 4
4 2 2 2 2 2 2 2 2 2 2 2 2 2 2 2 2 2 2 4
4 1 1 1 1 4 4 4 4 4 1 1 1 1 1 4 4 4 4 4
4 3 3 3 3 4 4 4 4 4 3 3 3 3 3 4 4 4 4 4
4 2 2 2 2 4 4 4 4 4 2 2 2 2 2 4 4 4 4 4
4 3 3 3 3 4 4 4 4 4 3 3 3 3 3 4 4 4 4 4
4 2 2 2 2 4 4 4 4 4 2 2 2 2 2 4 4 4 4 4
4 4 4 4 4 4 4 4 4 4 4 4 4 4 4 4 4 4 4 4